{
	"size": [16, 16],
	"spawnpoint": [15, 15],
	"monsterspawn": [[0, 0], [0, 3], [3, 0]],
	"ground": [
		".,'.,`,,,,',,',,",
		",,,,',,'',,,',,,",
		",,',,',,,,',,,`,",
		".',',,,',,,,',,,",
		",,`,`,,,,',,,'',",
		"',,,#,,`',,,,,,`",
		"`',,#,,,,,,',,,,",
		",,',,'`,,',,',,,",
		",,,,,,',,',,,',,",
		",,'',,,,,##,',,'",
		"',,',`',,'`,',,'",
		",,`,,',,`,,',',R",
		",,,'',,',,',#==#",
		",'',,`',`,,'=+++",
		",`,,',,',,,'=+++",
		",`,,'`,,'`,R#+++"
	],
	"creatures": [[[11, 15], "Pillar"], [[15, 11], "Pillar"]]
}
